###################
X     #      #   @#
#     #   #  #    #
#     #   #  #    #
#     #   #  #    #
#     #   #  #    #
#         #       #
###################