#################@#
X     #      #    #
#     #   #  #    #
#     #   #  #    #
#     #   #  #    #
#     #   #  #    #
#         #       #
###################